#I##################
#   #      ##      #
# # ######    #### #
### ##   ## ###    #
# #    #  #   # ## #
# ####### # ### ## #
#      #  ###   #  #
## ###   ###  ### ##
#  # #####   ##   ##
# ##   #   #### #  O
#  ###   #    ######
##   # ######      #
#### #  ### ##### ##
#  # ##  #  ##    ##
# ## ###   ##  ##  #
#  # #   ###  ### ##
## # #####   ## #  #
#  # #   # # #  ## #
##     #   # ##    #
####################
